GGGGGGGG
GGG#GGGG
GGGGGGGG
GS#GGGZG
########
